10 20
XXOX X OO X X OO OOX
OX  O  OOOOOOXXX OX 
  OX  OOO O XXXO XOX
 OOOO OX OXXXO XX   
OXO  OX XXXOO X OO  
 O XX    XOOO X   OO
OOOOOOOO XOOX   X   
OO XXOXOXX OO XOXO O
OOX  X OOOXOX  O OOO
O  O OXX      OX   O
